1111211111111111121111111
1                       2
2                       1
1                       1
1                       1
2                       1
1                       1
2                       1
2                       1
1111211111311111121111111